--|M---X-|------X---XX------------B-----?T-X-||----o|?----M--E-----o----------------------------TB---ooE------?----B--BB--------MM-----?--T---------o---------EE--------------E-------?---------X-------
--E--XE--?X-?---------------T-----TBM--|M-----------M------------------X---T-|----B-------------|EX-----M----------E------o--------TT-----|----------------------T---?---------------T-X---|------E--?X-
----M-------BTB-------------T----------------------X------BB-----------|-----------o-------?----|X--B--?-MX---oEBo|X----------------|X---------------------?----|--o-M--M-----X-o--E-|-o-----E----------
------?------------BB------o-------M---?B--M---o--BE-----M--o-|------?X|----oT--T--B----B|--X----------B-B--------------------------|-----|T-T---M---------------T-|-|?--E-E-oT||-E--|----------M-B-----
-------------XM-o-----M?--B-|------M-T--E----o-?------o-T-|------o---M-E---EE--B----------------|-------------?--o-?-B-T-|---E--T--------------------M-M--||?TT-----B--------------|M------?--|M--|-XE--
--T-------------------------|----EM----E-M|--?-|-----?--o----T-X-------|-----|---X-|-?-?---TT--T|-?-B--o-o||------------------------|-----|-------------------|----------|XE----------------------------
--|---B--------------------------------------------------------------E---------------o---------M-----------------------------X----------------E---------------|-------------EXB------|-EM--B-M-----B-M--
-T|XE---Bo------o--|--------|-----------------T--------E-oBX-----M-|-------X-------X-----------------M---EB-?---B-o?EX---E-B?X----X--o--T----------------X-?--|---B------T----?---X--T|T-EM|-T---------v
--|-------------X-----------|----------|?X?--X|---|-XMM-E---------------------------------T--X-------o-o-oo---o?-?|-o---B?------|---------|-oTT---------------|------BE--?X-o-----E|-|----M|-?---------f
--|--------BM----M----M-----|-M-----X?X-------|---------?o---------------X---|--|-X---TB-o-|------E-T---?---------------------------|-----|--E|E-----?-----XoM|-M|---?--o-|---|?oX-|-|---------|--?T---f
TT--------------------------|X--E----X--------|--------------------BB-|--X----?-T---E----?-T----|T|--EE---?----?-------|-|M-?o-E----|--E--|---|?--TM|-oEEB-|--|-?T--E-----|--------|M|M--------||------f
-|-B------------------------|----------------B|-------------E-T---?---E|-------------------||------------M-----o-------------?EX--X-X----E|----------------------|--------------?-X|||--B-E|--B|-B-B---f
-||-------------------------|-----------------|----B-------------------|---------------M------BT|--------TT----|-|B-------M-BX--|o--|--oXT--X------?-----?o---|T-M|M--T-|?|--------|-|-----------T-|--Bf
-||---------MX---B--X--M-X|-|X----|--|M--|--E-|E-M?--?-----B----?-----B||--X---o-----|-B|-X|----|-------?-------?-o-M-T--X-o----|E--|?----|MX-|--?-?----------|oT|M-----|------?----B|--------|----M---f
m||X---M--------------------|------ooE----B?|-|E----T-X-BM-X-E|MB-----E|?-----T--?|-----|-||-------------TTX--T---B--M?E-----B-M--E||X---o----|------------|--|?-|--M-----|--------|-|---?------|------X
XXXXXXXXXXXXXXXXXXXXXXXXXXXXXXXXXXXXXXXXXXXXXXXXXXXXXXXXXXXXXXXXXXXXXXXXXXXXXXXXXXXXXXXXXXXXXXXXXXXXXXXXXXXXXXXXXXXXXXXXXXXXXXXXXXXXXXXXXXXXXXXXXXXXXXXXXXXXXXXXXXXXXXXXXXXXXXXXXXXXXXXXXXXXXXXXXXXXXXXX
