------------------------------?B-T----|----TT------------M----------T-----?--B--?-----ME--|------?--Bo-T--M---------------------M---------o----?T---o-o------TT------oT-E-o?BB-BTT-E----?--o-?-------BB-
---BB--------------------------------BB----o|----X-B--X-X-----EM------EX--T--?TE---|T---------------o--|--M---E-----------------E---oB-T----X----------------o|-X-------T--?-------E---E?BB-------T-----
---B------M-||--E--|-------------T---------XE-X-------------|M--|oo---B----B------M-o--M----B-TTE---M-------------M--|BBTo--XoXo--M-X--o-B-|-T--|-------------|---------------|--|?---------------||----
--------T--?o---------------------------------?----?------------|------|-----BB----------------------------------------------BB-----------------|-M------oT-M-|------B-?---?-----|--------T-X--o--|-----
----?X-|o-?|-?M---B--------?o--M--E-T-B------M--|T|--o--------------------------------------------------------------------o-|||--oo---------M---|------M--------BT-----|----|B---|------------|-o?|--|--
-?--T-Xo---E-------?----MT--------TET----|?----BM-XT|----o--?---B----|M-|?T------BT----oXB-M----------------?|B-E--o|------------?-|----------E-|To----?T-----|-----|---B||--------TX-------------||----
--------------------------------------|-----E----------o---------------|B--?TX-?--?----M----M-X----X-?X----|---?o-----------|T--o-oX-o---?-?----|----------------------|TT--?-|--|--B------B-M----|-----
---------E--?BX--T---------------oB?-B|---|?|--E---BT----------|--o---o|-o----BB|---------------o---T-E----------------------------M-----EE-----|E------|-|---|---E------|---X---|?----------------|---v
----Xo---X--------------o--------|-----EE--Bo---?o-?E-----BoMX-|-o-----------------------------------------|-------B?M---o--E-----------BX---??-|----------E-------------|--|----|--------------BB||TT-f
--M----|BB---------------E------------|-----|----E---X--------||----M-----|E?-EM---E---|-?-Mo|-E-X-B--TM----M---------------||----------------------XE--|-E-X-|-----X----|XoE-|-T|------|---------||-|-f
-------|-----------X--------?---T?T-TT||-?T-|-M---------------E-----BT?----M--?----ET-----M-T-------|---XX-o-----E-MX--------------------------M|-B-----|T----|-----T----|-------|----------------||-|-f
-------|-------------o-o--XT|---|-----------|--------TT---------------|--XTXT-B-T--X??--|---B---|-|-o-----------------E-oX--oXo-?-E|X-B|-TT-X---||---o--|----T|-----|----|-------|--|-------?-|------|Bf
------?-------|-M------T--------|-----|T--------------|-|--X---|T----B?-----------------------------|---------X-o-----------||------------------|------X--|------T-?--|-M-E-|T|-o|T|-----M-----TTBB--|-f
-----XT-T-B-?---Xo-o|-----------|---------------T-----|--------|-------X-------------------B--oTo---|-oo---|X-E-----T-|-M-o-||XX-?-T------?---Eo|---|---|-----|---------------?--|--------------|----||f
m----------o---------|-----TT---|--TT-----|--B-----B--|-X-o-?-TT----E-?|--------M-----T--------------M-T--B?----o-X?o---X----o-?----------------||--X---|---M||------?E--|---X|--||-------------|-||-||X
XXXXXXXXXXXXXXXXXXXXXXXXXXXXXXXXXXXXXXXXXXXXXXXXXXXXXXXXXXXXXXXXXXXXXXXXXXXXXXXXXXXXXXXXXXXXXXXXXXXXXXXXXXXXXXXXXXXXXXXXXXXXXXXXXXXXXXXXXXXXXXXXXXXXXXXXXXXXXXXXXXXXXXXXXXXXXXXXXXXXXXXXXXXXXXXXXXXXXXXX
