--TT---XE------E--XB------T--BB-o---X-----------------oEE-------------------M-----------------To---------E|-o---E---E-XoT---X---M-------o---------------o-----E-o-----|-|M|--E--X--XX---BB-----EE-------
-o-|----E---?-------------------E---o-XXTT------TTX--ET--B-Xo-EM?-M----E---E----BB---------------E-M--------M---------X----X-------M-|-----------------------------------BB--------X--------------------
---|-X-----------------B-------o--M----o-?BM--?--|----------TTMM|-?--|X-TM-------------------------Mo?----o-X--|T-X--|-----------|---------M-EX-----o---T----TB----M-M-o---To-M--------------T----------
---|------|-B--B--------------|-------E-B?---oB--|-----M---------------------oM---------|-M----|--M----------------M-MX----?EE----ME-------?E-o-|E?-oB--B-----B---||--XM-?-o--o----X-?--o|-|?|o---o-----
---|o---T?M|--|oB-T----E--BB-------------|--X--|X|XM-|-----|--------------------------------------T----o---------T-|----T---XM-----X--XT-----------------M----------------------------E-X----|----o-M---
-?-|----|TB?ET----|--------------------|---------|------------------------?---X----BET--XM----MM-E---EoB---TT-M-X---?-----|X-B-BB--?-o-------o--|------------------------?--o--------------M-|-----B--T-
-X-|----------oB-XBM------------o-BB-------X-?--B-----T------------------?---|o-----B--B---|-M-M---X--E-M--B---------B-|||||E-------o------E---T-o?------o-------E-|--MX-B---------------E---|X-?-XTE-|-
-BB------------o---------------------------------|--B------------------------B-------B?M-TX------MB--X-----EB-XT?--?-?--?-|----MX|--|----------|-------------------|------X-X-B---T-------------------|v
---|--------------|M------M|-?---T-------|-----|X|----E-----------------------------|------BT-T--------|--MT----B----?--o||-M--T---?--E-------E||---T--XM-E-o?----ME-------------------T-B|-o|------TT|f
---|------o--B--------------?----E------B|-TT----|---------MB-|----T-M-B-T--T|o-----|-|--------|-T--M?----|EBB-E---------TT--BXM---EE----------||--E--------------|-------------|BM----?---o-||------|-f
---|?---X-----M----------------X-E------M---|----|-------------------------?---?----|--B-BoT-----------------------------|---------------------||E-------X------|-||----oM---X----|----EE-o-?|T-o----||f
---|E-------------|-------T----M-|--E-------|-|--|----------------------------------|-BB------------------|-E|---oM------|-----E----BB---------||----------?-----||-----------------------|--|-B-----|-f
---|------T-------|---X----------|----------|-X--|-B--o-M--|------------------------|------------------------------?oB---||--------------------||--------XB----?-------------------------------|-----|-f
---|-EoT-M-------X|--------------|------------|X-|-------------B--M------M-----T--------------?----?-|----|E--ET--M-----oM|---Bo-|-X|----M--X--|-----T---T-BB------------------------B-------|-------||f
m-----------------|-M----X------------?--|MXoX|o---o-----|-|XM-------E--XT--?-?|-------------------BBE-X-|--oM-------M---||-X??-E|--|-----T|---|---Bo|---BM----?--o---X---Mo------X--??o-----|-M-----||X
XXXXXXXXXXXXXXXXXXXXXXXXXXXXXXXXXXXXXXXXXXXXXXXXXXXXXXXXXXXXXXXXXXXXXXXXXXXXXXXXXXXXXXXXXXXXXXXXXXXXXXXXXXXXXXXXXXXXXXXXXXXXXXXXXXXXXXXXXXXXXXXXXXXXXXXXXXXXXXXXXXXXXXXXXXXXXXXXXXXXXXXXXXXXXXXXXXXXXXXX
