------M-------o--------------------X----|--X--o--BEE--|----?|----E-T-o-X-----------o-BB--T--T?M-M-T---||--X--o-------------------------------?-------M---------ooE-----X----T--E---M-----M------------T-
-|--X------X-oX---M--|T-T-M---X--X-|----?T?E-BM-----------M----------E|--TT-o--X-----?--------M---|---|----M-------T-BX--E-M-----?---------------BB----------E--T-X-E-B--|X-|---|---?-o?E-E------MBM-?--
-M------o----o-----E------------M-----------------T-B--?--o-X-------|------------M---------------------E|Eo--X-oB--E--E--------T-----o------BB--------o----------------o--?------------TT--o-o-E--E---?-
--X--BEM?-E|-XETo-----|-E---------------------------B-----------------------------------B------------T--------------------------o----M--|----X--B-XBoT----BB--B---E-o----------T-o-T---|oT-|---M-B----T-
---MoXT---T-B--o-----M-B-|X|---X-------------To---B----|---BB---M---|-----------?oXT----?-BEB-T--E---|-|E-------------------------------------------------------o-B---?M------M---T-----|||oT|-------|--
-|o-X-----------------E--BB-E--B-X----------------------------------|--------BB-------oM----T-------?|--XTEoEM?M--------T--X-TE--X-MoE-----E-----------------------?Eo-TM-o------XT-M---|----|-|-T---|o-
-?--oB|-o-TB------------------------------------ME--M------------TM---TT-----------o-------?-|o-----E-||-----------------------|-----------E-------------E----------X----E-|------------|----|----------
-----ME-----X-----X-----------?--------M|------------------------------|--------------------------M--|-|-----|Mo--EX-------o---|T-X|----------?E---M-----o-o|--M-----------------------E|-M---T-------ov
---T-?T----B---TM--E-----M-?|--B---M--MT-BT---T------?o-TB--B---M-|-|--|B-------o--X-----------------|-||-?---------------M--o-----B--M-------|-|M--X-o---M----TXB---XM-?-XM?----E------|TE--|-TT----B-f
-?------MEM-----------------------B---X-?---------------------------|--------X---------------ME-----B|?|-Xo---------M-----X----|-|-------T---|--X---o----E--B---------------?-----------|----|E-|-----Xf
--T-----?---?---------------------E---|-|-------BB----------------M--X--T?o--------------------------|------E--o|-?o---BXE?---------------X----|------M-----------------------T?B-|M----|X-B-|--|-o---Ef
-B--X----------BX|o-B-ETT------------------ME-B-----MB-B|-----MB----|-----o-?------MB---M------------|---B-B---?----------------------------M-----------------M|Xo---BMo--B--T----T------X?E-|o-|--E-X-f
-----------|---|-----|M-|---X---T--M-T||------------E-?-----To----M-|--|---M----o------o-?-----------|-----------o--??o--T--Bo-|---------------|--------------X|-?----------------?-----|-|--|TT|-|--XTf
-----?-?---M--||T---------|---B-------|------------------------------X-|---|--------M--X-----T--oB-T-|B----T--|-o---E--T-?---X-XB-|------------|--------------------------------E-----------?||||-----Xf
m------X-----------|X-T-|---E---M---BB|-|--?----|---M----X---------M--||-TT-----------------BB-------|-------------M--T--------|----oBBE---B---|---|--BT-|??--o---XXB---E-o-----B----?----E-?|||-X----?X
XXXXXXXXXXXXXXXXXXXXXXXXXXXXXXXXXXXXXXXXXXXXXXXXXXXXXXXXXXXXXXXXXXXXXXXXXXXXXXXXXXXXXXXXXXXXXXXXXXXXXXXXXXXXXXXXXXXXXXXXXXXXXXXXXXXXXXXXXXXXXXXXXXXXXXXXXXXXXXXXXXXXXXXXXXXXXXXXXXXXXXXXXXXXXXXXXXXXXXXX
