-----------------M---B-BB------M----?-T-M--|-M----BT-M-X--?------M-?-BB-T---BM-----oM|M----M---------M--?-EX---?---MMB-T----TT----?-Xo-------E-M-Eo----M--o--BBTT--E---XB-BMo------X---MTo--T-----BBE---
---BB---------------------X----------------MoM----|o--|-------M----B--T----??------XM--------TB-B---------E-o-------E-----E---Eo-|--T---EB|----E?|-M--XB?-X---?--M-----oX-XoEo--|X----------|----o----X-
------------------------|--?----?---?M---T--o---------|------EBE----------------?MB---XooX--o?------M-|---MEXE-E----oM----|-To---------B---BT--E-o-M------------|---------------------------|--------T--
--TT----------X------X-----------------------------------------------------o-----|-B-T--?-----------------------?T---o---T---------------------------------------------------------------------------|--
---|-----M-------M----------------------E-T--M-E------|-|-X-o---E---------To-EXoM-XT-?T------B--E----E----X-E|-T-------EXM-|---M-|----------------------BB------------?----E--M--EX-------------M---BB--
---|BB-------------?--MM-----X-E--|-T-E???--B---X-Mo--T--X---M-----E|T-?-?-B-------|-T|-------------------?---o--M----------EB---oo-E-----o--?-------------------------o--EX-?M---o-M|--B---|TT------|--
---|----------------------------E--?M-o--?-X-B-M------|-----------------|----------X-T------E--B--o------E----------------E----------E--XTo------B--|--B---------|-X----oo-------------E---||--------|--
---|-----------------------?X--------?-oE--------|------T-o--o--------|--------------------------|--------?X-|X--------|-----------------EEM------M--|----------BoTMXo-B?----|----------|o--|----------v
--M|------------------E-------------------o------------X--------------|B--B-------T----BBE---|---|TX?--------|-----------B---X-|?o-o------B-BM---------?----------Bo-------B-----------------E----M--|-f
------T-----BB---T-BB-------T-----|---X------B--Bo----|------T-----T---T|--o|-|BB--M---------|--------?-------------|-||-TB----E---o--E---------------X--TT-X---|--------|-oT--------------Xo----------f
---|-------------------------B-|-?----TT-----o--------|-----To---E------|----T--------------E|--B--|----?EXT----------------------------|EE-|---XT-X----E---E------T-?|----E-|--XXEBB--|----|----------f
---|---------------X-----o----o|--X?---|--------------|X----|----------------|--------o---BB-|--------------------------------oM|-B-E--?X-----E--------------TM-----B---BB-----------------B|----------f
---B-------------------------BB---|X---|--------BB----BB--------------|---------o--|-------------TT----X-----|----BB-------?------------M--XT----|--TX----|MM--|E-----?-|----|--|---?------T----|------f
-X-|---------------------------|------X|--?-|---------|-o---|?---|--T-|?--B------o----M-B------X-B--?--T----M?-M--|-To-|-B-o------T--|-|------------------|----|------o-------------------Eo|--EMo---|-f
m-EBB---EM-----------MT---|???-----?--M|-|-oBB-------------E|----|MB-||--EX|----XT-------?-------|o----------|---E------?---E-T--B-T--X--X----X----X---X-M---EE---BB--------B|--------------|--------|-X
XXXXXXXXXXXXXXXXXXXXXXXXXXXXXXXXXXXXXXXXXXXXXXXXXXXXXXXXXXXXXXXXXXXXXXXXXXXXXXXXXXXXXXXXXXXXXXXXXXXXXXXXXXXXXXXXXXXXXXXXXXXXXXXXXXXXXXXXXXXXXXXXXXXXXXXXXXXXXXXXXXXXXXXXXXXXXXXXXXXXXXXXXXXXXXXXXXXXXXXX
