------------------|-----E-?----M-----M-E--Bo------M--TT-E--o-EE--------------o-----o--------EX-------M------o--?M---o-----------B--------?---MB-X----Xo---BB---T--X---E-----------------------E?M-------
---------MT-BTT----------B------------------------M---|----o--------------B---------BB----BB------E----------T----------------M----BB----------------------T---|-------oX-------------------------------
---E--------------B-T---T?--|B-?B------oE--------T----------?X-|--oM------B-----XE-----------|-T-X--B----BB--?--?---------------------B--?--BE-|-B-|?----M-----|-----BB----M---M---T-B-M-Xo-BBE----?----
------------------X-----------------o--B--BoToo----B--|-E----M-----------------------------------------|-------------T------E-M------------------------T-------|-----TT------------------------T--------
-?--------EM-?X-M-?---MT-------o--|B----?---|-----T-|--------T----------M---M-------------B--M----B-o-B--?----|-o--?B|-?|--T---BE--------E--E-M----------------|------|---E--T|------T-?-----------o-|--
--------|---|-M-----------------|-----------|-----|-|---------|--M-------X--?-M-B-----E--T-------?-----M--?-------X--|---------X--|--X-XT-?---|-?-oE-B-T|-----X|M-----|-------?-----------?-------------
-------?|--?-E--B-E---?X----||--T--o-----o---|-|X--|-----XB-B-|-------MTM--B-------E-----------------------------T---|--E-o---M----X|----------------X-|-|--o-o|E------oX--T--MX----M---E---X--|--------
-M-------------------X-B--X|-E||T--E--XBM---|X---EX-----|-----?X|------|----------BM|o---------------X-B--------EX--B|Eo--T---X----M----|------o?-------|------|M--B-B-------X--------------T----------v
---------M---|----T-|--------X---------|----|-------|-|-------------------------E-----------------T----Eo------M---T-|-|-T--------------|-------------?-o--X---|------|---|-----------------|--|-------f
---|-------BX|-----?------|-------X--Bo|----|---B----M|--|?-|------o-----------------------------|-X-----------------|--Bo--T--E|-?----|----E----------------o---EM---|--------M------------|--|-----BBf
----T----------------------------------|----|M-------------EB-|--E---------M--T?XT-BB------?|-B-?|--E-----o---?-?----|----|-------------|M-----B--X||-X|M-----E|---?--|TEoXoM------BB----M-----|-o-o--of
---|------------|EoT---T-|TB-E-----B---E---M|----MBM-B-ME----|||M-M-oE--E-----------------o------|-----|----BB-?-----|----|-----?B----------M-o----?------E----|--oXB-|--------------T----|-|--|--B----f
--------TB-----|Mo----||--|--X--------------|--oE-|--|------?E---M--M--M----B-|-----E------M------?-B-T---B--B--?-|--|----|--?---TB----?|?-----------|-------o?|----BBT-B------------|------|-BB---|o--f
---|-----T-------------B--|------o-----|----|----||-T|-T-o----|-------------------M-------------------------B---o-o?M|M---------o--o-o-M--EX-?-X-|-------------|-XT-MX-------------|-||---|-|--|---|---f
m-XB-?----|---------o----M|-----??--o-|BB---|-------|-|E-----|-----------|----------------|-?-M--|E-o-X|-?-M----TXE--|------------------|--------|-ETX?-B--|---|------|----TX----T|-?|---M--|E?-------MX
XXXXXXXXXXXXXXXXXXXXXXXXXXXXXXXXXXXXXXXXXXXXXXXXXXXXXXXXXXXXXXXXXXXXXXXXXXXXXXXXXXXXXXXXXXXXXXXXXXXXXXXXXXXXXXXXXXXXXXXXXXXXXXXXXXXXXXXXXXXXXXXXXXXXXXXXXXXXXXXXXXXXXXXXXXXXXXXXXXXXXXXXXXXXXXXXXXXXXXXX
