-|--M--BX---T----T---Bo--X----T-TBB|--B-E--o-ToBM-oo------------TT-------X----BB-?----X--X-------o-B-----T----|-------?--TT-B---B----T--T---------M---------BB-----BB----X-M-|-B-E-?o---M--|-E-E---M-o|-
----------X-------X-|---oE---B|-------?-------------------T-----------------------------T---ET?o|MXEE-X--E---M-B|-|-T|o---------B----------------------?--BB----------B---------BB-----------E--------X-
-M---o--T-E--------E--o--?-?--|-----------------Eo---BM-----T--BB|------------|---------|----M---oMX-o-E--ME----|--M--TX?-|------------M-------X-o-----------------------E---------------B--------o--EX-
-T---M---|------------------T-X-----|?|----E-BT--E----|-?T-To--B?--T-E-|--MM-----X------|----------------X----------------|------T-----B?---E-|T----|--T--E-T-----M-----T-T-----------M----X---B-o--E|--
--|-o------------|----|BM-----|-----X-T-X--TX--|o----------------|---BB---------T-------|---BB------E-X-----------|------------|--o-ET-----?o|B-|----|-T---M---ME----------------?---B--BT-T-----B---T--
--E|-o---X-B-----o---------------o-X--------------o---------T--B-|--o-o|XXT--E|-TT-----XX--------------------------------------------|B-|------|----------------?X--o?--B---|X?B-oX-----T--E--E-Bo--B-M-
----o----B--XX------------||XXE--E-----M---X-------?------T------------------|---||---T-|----?-MM|o---B----?T-o-X-T--B-E|---TX-----ME|--|------|X--E--?M-E-----|T----------T--ET---B-------M--T-TX-X-BE-
--B---X------|---|---M------B-|--E----ME------E--E-o---B------------|-?B--------||----|-|-----------------------------?TE-|EE--B----||M-|M-TE--|TM-E------|E---TE--B--?--M---MB-----Eo-E|M-------T-----v
-T-----|E--XM-B-|---X-o-o--|X-----B--XXo--------?----------|-----|-----E---B--|-||----|-|----------|T------------|M--E|E--|-------T--|-||------|----------------------------------------|------|-E---XTf
---?-M-------|---BX----M----oo|E-------------o----?---?---X-|----|----E-------|-||----|-|--------------M-------|------------|--------|--|------------------------B---X-E?o--X-B---|-M---|-o--oX--X-----f
-?-------o--|-----------------|-----o--------??-T-B--------|-----T-----------BB-||o-o---|---|----------?------E|--|---EBM-EM-T-E---Mo----------------------o---X---------------------X--?E--X----?-XM--f
-T|---o--M-?-------T--E-----------B---?X----?---o-E---BB---|ME--M-------|--|----||-----------|---?o-----------------------|----------|--|----T-|--X--o--oXE-----XB----|-|----E-?TE---M-?E-------------Mf
------------|-----------------|o---------------X-|-|------X------B--TT---------B||----|-|-----E--?|o-------------T--M---E-|----oM-?E---ooM-X-T-|-T---M--|?----E--B------|T--M-----------|----EEM-M|?-TBf
-X--o-------||---|--M-?-------------T-----T-?--------------B-oB-X|--B---E-----|?||T-T-|-|B-T-E---?|---------?--|---------M|----------|--|--T--------------------------MTMB----o-X----B--?TM---??|-M--oBf
m--|--------XB----o|-----------------------M-------BBB-----|T----|------------|-|||---|-|-|--|-o--|-------------XX--TE--o-||--------M|--|--|--||--TT--------M----?------?----------||o-M?X-o---B-?--X--X
XXXXXXXXXXXXXXXXXXXXXXXXXXXXXXXXXXXXXXXXXXXXXXXXXXXXXXXXXXXXXXXXXXXXXXXXXXXXXXXXXXXXXXXXXXXXXXXXXXXXXXXXXXXXXXXXXXXXXXXXXXXXXXXXXXXXXXXXXXXXXXXXXXXXXXXXXXXXXXXXXXXXXXXXXXXXXXXXXXXXXXXXXXXXXXXXXXXXXXXX
