-?T-o-TB----------oE--------------Mo---EM----E---M----?----------------M-----T|o--E--oXE-T------E?ETT--?X-------?-------------------TT-T-----------?-----------o-------------?-----E-M------oMT---B--?--
-B----------------------------T-------------------------M------|-X------------------X-----M------T---EEX------------EX-?|o-T-MMM-o-B---------------------------X--------------T-----M|----?M---M--o?ET--
-X-----M-M---|TBo-------------------------TM?-----T-E--X-?X?T-------B-M|--o----------------------|-----------------BB------|------T------BBE-----------------X------X--------------------------EMo---|E-
-T-Xo--------------------?o-o-?--MM-----MT---T---M?----M----|-T------X--X--MB------T|---M---??-o-|--|------------X--T-----E--|-T?-----oB----o--oB-MoM------T------BB-------------------oT--------X----?-
--?T---------------X-T--BT--M----M-----o-MM----?XTT-XE---------T-----------------|--M------X-M-------------EM--TT------------|-X||?X?|-|---?|BE--?-----M---------------------------------------------E--
--TEE------B------E-MX---X-XTT-M--|M|--B-o--?o---|-------o-|T-MBB-----T?E-E---o---oX-------------|--TX-|---E|-B|---|------B----o|----|----o-----|oB--|---------------?--E--T--T-------T||--|X-----------
-|-X--B-------------o-E?o-T-------------------------------------------------T------T-------------|--|-----------|XE----B---?o---|-----?--?---------B-------------------------M---E--------E----?---|-oX-
-XoM----T-T--|T-Eo-----T--|E--|-------------M--o----T------?B---|X|-M|---------------------------|--|-------|--T-ToB-?--T-|-T--E|---X|??-?oE----X-------------?T-----X------E--B-|M----B-----B---------v
-|--T-----T-ME-M-o--------------?-------o--Bo-M-|--|---E-T-------T--XME-M----?---X-----|XEM----XX|-?|-?o----|XB-|-|-------------|----|--------------T--X-BT-------X-?--T----B---------------B-MME------f
---TX|-------|--BE---------E|--?TB----E-B-M------------T---X-M-----B----X---|-|-B--?-|---B-E---E-|-X|X-X----|-------------------|--M---|BB----EE-----------B------|B---|X----|?ET-------------o?----E-of
--o|---X---o--------?-T-EXE--------------EXM-B---oM--|-B--o-o--|--B---T|T-----o-T-------E----T---|--|-------|---|----------M----|-|?o|o--------------------------------|-----------?---T?--||-?-----|-Xf
---XM--o--B-------------------------|--------------------------||-----------|--------------------|--|----BBo--ET|----M--B--BM-B-|o-B---BB---|----TTo------------|?-----|--|?oo--E-X----M-EM-B------T---f
--X--------------XB----------------B|-M------------------------||-----------X------B--B----o-----|--|--M--------|-----------B---|-T----------|-MTBT---o?-MM-T-X-----TX-|--?M-|----TX---X|?---|--oX-X--?f
-o----X----BM---E|E--o----BE---EXE--|?X-----B-----B-M---To-E-E-||M-XM--M-X--|----M|-----T----M---|-?|M?-M--T----|M--------------|--?-|------|-------X-M---------o-----o|B--------|---X-||E--XE---?-oMEBf
m----------------T---------?----?----------------------E--|?--BB|----T---E--|M|-M--|?o-o?--?BT---|X-|-----------|---------------|----|-|--B-||------------------E-|----|------|oB---?---------MM--E----X
XXXXXXXXXXXXXXXXXXXXXXXXXXXXXXXXXXXXXXXXXXXXXXXXXXXXXXXXXXXXXXXXXXXXXXXXXXXXXXXXXXXXXXXXXXXXXXXXXXXXXXXXXXXXXXXXXXXXXXXXXXXXXXXXXXXXXXXXXXXXXXXXXXXXXXXXXXXXXXXXXXXXXXXXXXXXXXXXXXXXXXXXXXXXXXXXXXXXXXXX
