---------------?----------M------XM?---------------------------?T-----X-----------|-----???-TM-----XX--------------------------XT?---E----------?---T---?--T|----o-|T-----------------T|--EoM---?-T-E-?-
----M----BB?----|E----E?-o-------X-E----------------------------T-----?---o---T--T|--X--X-TBBTTM--M-o-|-------------------B-BB-----|----------M--E-|-------||M-------?--BE-?----|B----|-------TT-??XT---
------X--------E----------------------?--?B----E------?--------T|--|--------E------M--?--oT-|E--X------B--o-M|-------------B----|------E-M-|-------|-------|-------------o-----BEX---T|---?---------|---
---------?-------T-E---TMM--------------------------BB----o?----|-------------------M---------------?--------T--o?X---X-T-|BE---|----------|--|-------X-----T---?--X-----?-oE---------|-------------|---
---X-------?----|--X--??-o--B?--X-E--T-----|--------------------|----E----M-T-X-o-----B-X--Bo|---T--E--B-o---|X------------M-oM-|o----E-E--B----M---oEB-M--||----oE-------X-M|------|-|--TXX------XB|---
----------------------------------oE?TB---|--T-|-?T-----?oEB-E?E-X----o-B--TT------------T--------B---------?--------------BB---M--|-M-------------------o-|---------MM-BX--------------------------BB--
----------------M--------|-o--M-M-T-E---o--o-MMB|----------o??--|-----------|----o----X--|--|--------------?----oT--ME---E------|-X---E--|-X------o---oo-XEE----BB------------T-----o-|-?--o-?T-----|---
----M--?-E--M----?--|----|o-------------------M-T-B--?-E---B--E-|T---M-----MT------BB---------E-M-----------T-X------------|-T----E-B--|-------------------|----------|------------------B-----------o-v
-----------BB---|------EX-|-|---T--|E------|-|-E--|Xo--T--o-?---||----------|--?-TX---------||-----------------------------------------------------X?---E-B-|--------T|--?---X-X-M----|--------------B-f
--------------o----M|------------?-B---X-------T-?-T------------||----------|------------|--|------------------------|-X------BB|--------To|-M|-MX|--T-T--T||--E----M-|---------------|----M--------|--f
--------------?------------TT-|-E-------------------------------||o--|--X--E|--?B--B-|-X-|?-----M-----|----------BB------M---------|ET---E------------B-o--TXT--|B-----BT---M-B-B-B||-|-------------|--f
-----M-------o-X------------|--------E-------|-|-----------T-|-T||--M|-------E-EB---------o--EM--||-----------------------------|------EX--|ETX--o-|-------||-|M---E--|TM-------T--|-X|--?--------BE|--f
----------BB----------------|o|Bo-X-----M|-|BB-----M------------||----o---T-|---|----|X--|---|oE-X----EMM-T------------X-X-----X---|----|M-|-M-?---?-E|B--BX--X-B---X-----------------X-|----MoXo---|--f
-------T------T-|---|----|--|-|--------B---|-------------X----X-||-X-|---B--|---------------||--o||M--|M-----B-----------------T---------------------|M----||---------|-----|---------|-------------|--f
m-------------|-|--T|--X-|-----M----o-EE-oT|--?o---------TT-|---||----------|-----BX-X---|T-|XM-X---X---BT--?----XE--|----XB------B|-------|T----T-E----M--||-|-E---B||-----|-M------X|------------TT--X
XXXXXXXXXXXXXXXXXXXXXXXXXXXXXXXXXXXXXXXXXXXXXXXXXXXXXXXXXXXXXXXXXXXXXXXXXXXXXXXXXXXXXXXXXXXXXXXXXXXXXXXXXXXXXXXXXXXXXXXXXXXXXXXXXXXXXXXXXXXXXXXXXXXXXXXXXXXXXXXXXXXXXXXXXXXXXXXXXXXXXXXXXXXXXXXXXXXXXXXX
