------?--M-----E-X--?------?-----EMX----oX--E--X---E---E--o--|----XEM-B-T--E----M?|o----X-----o--X-E--?----T-T-------EE---T|-------------o------|------E-B------|-E-oo?--M-|----T--E-o---X?---M---------
----------------------------------------E-o------ET----M----------B-?------o-------E-|--XM-----?o----------T---M---TM--T-----T--M-----|TT------|--E-T---oE-|-?------M--BX---M-----M--------------E------
-----------|--|--oE--|MB-?BT--B-----X-|--------M-MM--E---T--M-------?----X-----X---|??---B---|TBB---XoM-------------------|-oXE---BT|---|TT----?----BB-----M------------------------|-----B-?-----------
---BB--------------------T--E--MB--------B------o-MXoE-----------|-|?--?X------------------------?o-M-o?---ET---E-B---------------------|-|----|T-X-|---------------------------EX---------BB--E----B---
---------------------------------TM--X------M-M-MM-|X---XEo-------||-----o--------------------------------------o-----TX|--M-E------------|----|----|------------------|T--------XM---------------------
T---?Xo-M-||-oM--||B-----|---B-T--T---X---------M--B----|-M----o----------MT-B-T--oT--TEE--BM----?--------M|-----??EEB------------------|-|-M-X-----||o---------|----MM-------T|-----------------TT-----
-------------------------|------------------------o??--E?--T-M------------T-T-----|T-------T------BB-------|------T--------------XXM-M--|-|---------|---M-------------------------------?----ET---------
-------------------------|-----------------?-----------------------E---BM----------|--------------T----E|-|--T-?----M------------------B|-|---------|---|---------B----------TT------oX---EMT|-------BBv
-|B----------------?--X-----E---X-o--E--E|T-M--E-B--X---E-----|-M---------T----o------------|--------XB--------o---------TT-------------|------|------------------------------|------|---|-----|--|----f
---M--------T----BBBB----o--?-|----?-??---|-------M-------------X----------------------M--XB|-----To-------|MB-----|--B--?|--M-E--o----T|-||-?---T--|----------?---------MM--------------|-----|--|--EMf
-|-----------------------|----------------------|----------------------E--M----ETX-|--TT--B-|-----------------------------|----?--o-----|-|----|--BB|---T?-----------EM-|TX-------|--|-BM|-B------|----f
---------E-E-B---------------X|------?-------------------------------||-|------T------------BB------------|o|------|------|----------oM-|-|----|----|--?--------T--E----------|--------------M-|--|----f
-|---------B-X--|-X-T---T----o|---o-----X-|--MM-----o----?-o--X-----------B-B-M|E-TM-E--?---|-----X-------EM---?--------------M--X------|-|B--B|Xo--|o-----E-Mo-|-XX-M---------B---------B-----|--|----f
-||-------------o-T---T----------T-TT----------------------o--oT-E---M-T-|--------------------TT?---?-E?B--|-X-X---|---|oETM--|o-?----XB|-||---|----|-----------|---B-----?--------T--?---M----|-------f
mBo--------oEMB-XTM---E-BB----------|-----|----------------oX-----------------XXo----------?----|-|--EX-M--|?T|-------M-X-|------|------|o|-T-X|--o-|?MX-----------B-?o-------T---E-||---|-----|-------X
XXXXXXXXXXXXXXXXXXXXXXXXXXXXXXXXXXXXXXXXXXXXXXXXXXXXXXXXXXXXXXXXXXXXXXXXXXXXXXXXXXXXXXXXXXXXXXXXXXXXXXXXXXXXXXXXXXXXXXXXXXXXXXXXXXXXXXXXXXXXXXXXXXXXXXXXXXXXXXXXXXXXXXXXXXXXXXXXXXXXXXXXXXXXXXXXXXXXXXXX
