----------------------------------------------------------------------------------------------------------------------------------------------------------------------------------------X---------------
-------------o------------------------------------------------------------------------------------------------------------------------------------------------------------------------------------------
-----------------------------------------------------------------------------o-----------------------------------------------------------------o--------------------------------------------------------
-----------------M-----------------------------------------------BBB-BBX----B-----E---BBBB----E-BBB--------BBBBB-------BBBBBB-----BBB----M-BBBBB----------------B-----B-----B-E--BBBBX----BBB---B--BBB--
-------?-------------------------------------------------------------------o------B-------BB-B-B---?------B-BB-------o--------------------M------------BBB----BBBBBB--E------BB---o---------------------
-------?---BBB------------B-------------------B----------------------------BB-------------------------------------BBB-B----BB-----------------------------------------o--------------M-M----------------
--?-----------------BBB------B---X?--?-----------------------------T-----B------------?---------------?-----------B------------BBBBB--------E------B-----------------------o--------------BBBBB---------
--?-------------------------------------------T--------------------|-------------------------------------------------------o----------------B-----T-----o------M--B--B-------BB----BB--------B----ET---v
--------------B------------T--------------X---|-----------------?--|----------T--------BBBB------------------------BBBB-----B---------------------|-----BB-B---------------------------------------|B--f
-----?--------?-------M----|---------------X--|----BBBBBB----------|-B-B------|-----------XB-B-------B--------X-----------------B-----------------|-------------------------B--BBB------BB---------|---f
--B--------------T-----B---|----------BBB-----|-------------M---?--|----------|-----B------------------X-------------------------------oX------BB-|----E----------------------------B-B----B----BBB|BB-f
--B--------------|-------?-|----------------T-|--------------------|---------X|--------------------B-------------B----o-?--------------BB-B-------|-----------------X-o----------BBBBB-----------?-|---f
-B------?----?---|---------|---B------------|-|----------?----o----|--X-----XXX--------------------BBB--------------------------XXX---------------|B---------------XXXo----------------------------|---f
-------?-----E---|---T--T--|------BBBB----M-|-|---BBB-E------------|-XXX-o-XXXXX--BB--TBBBB----------------E-----B-------------XXXXX--------BBBBB-|---BBB-B-------XXXXXX------T-B---------XX-------|---f
m---Eo-o-E---o---|---|--|--|--XE-----------B|-|-----o----------BBB-|-XXXX-XXXXXXX----E|-------BoB--o-------B---?-------BX-----oXXXXXXo---Bo-E---TB|-----BBB-B----XXXXXXXX-----|EoBBB-----XXXX-----B|B-BX
XXXXXXXXXXXXXXXXXXXXXXXXXXXXXXXXXXXXXXXXXXXXXXXXXXXXXXXXXXXXXXXXXXXXXXXXXXXXXXXXXXXXXXXXXXXXXXXXXXXXXXXXXXXXXXXXXXXXXXXXXXXXXXXXXXXXXXXXXXXXXXXXXXXXXXXXXXXXXXXXXXXXXXXXXXXXXXXXXXXXXXXXXXXXXXXXXXXXXXXX
