----------E---o--TT-------?--M---------BE----M-----?-----o---M------E--------To--------?---M----------o-M--------X---------?----------Eo------M-----------------------------------T-BB--?---M----BBT-M--
----E---M---------|------o--E---?----?-----T--B-T-----------------TE----X---BB-----XXB-----B------M--X---B----|---|---|-----------------T---------------X-------XT---X-o------M-----X--?-X--?B-M--------
--------o--------X|-----|----------E-?X|-----|--X-|-------E----B|-|-T-----E--?------o--T----------------------|M-?----|--oo---------------------|-M-----|------------MT-----------E---------------------
--------|----M--BT|---To|----|-oT------------------------------o--|-E--BB-----|-------oE-----------------M-----B------|-----TT----M--|--?-M---------M-|--M--|--T-----T--XM----oo?-|oo----E--------------
--------|---------|-----|---M----E--o-MEB------------------oT|---||TE----E--?-----M---------|-BB-----M--------|-------|---B--|-|--X----------oo-----|--------------M-----B-?-E----|-------?---------T---
---?--BM|--|-----B|--|?-|-B-|--E---------------T-|----?---XT----|-|----E------T-B-------BB--|------B--------------------E----|----------M--B-o----||o-------X-T----------E--|-----|X--B----TT-----ETTo--
------------------|-----|----------------M--|--|----T---E--|------|----------||-------------|--o-X---T-----T--|-------||----M|----------|-B--------|-------|------------E|--|----?|E----o---|-X-----||--
--------|---o----M|---------|-----T-----?----M-------------------BB-----?BB--||-------------|----------o------|--M-|--|E---oE|----------BBXB------------M---------X--M----BB-B-----M---TT---|--------|-v
-----M-----T------||-E-----B---T-ET-----------B----X--------B---|||------|------------------M----M---------?---------B|------|----------|---|------?E---|---|o-----------o------------?-|-|-|-X-E----|-f
-----------|-----B||-BEX|---|X------------------------------------|----BB--|-||?-X-------B---------o--B---------------|------|-TT----E--|----------|----B-----TT-T----------------------|---------M-|--f
--|---------------|---ME|-X---?--------B-o-X--B--E-BB---M-------|-E-----------X---?-------|-------------------|-------||XE?T-|--------------E-T--B-T------o-|o--------------------------|---|-------||-f
--------|-?B-----||-----|---|M--------o-|--------|E-Eo-----|------|------|-|-|--M-------M-|----------------BB---------||---|-|--BB-------------E-|-|-----------|-|----T------B---M---M--|---|-------|--f
--------|?-|-----o-|------B-|M----|--?o-||-------X---------|------|o--?--TT|-------|--?---|-|---T?----TT-----|---E-o--|------|--------X-|--------|-|---M----|--|?------|----------------|--T|-T---o--|-f
-------||-?|------|-----|-M-|X----|o----X-----------------M---T-M-|B--T-|-T-E||---------o------------------|-----X---B-------|---T------|-MB----X--|----------o|-|-----|-|-------o------|--||------T|--f
m--------X-||XE---|T--------|-X---|--TTo|-------M--TTTT---------T||------||---|----|---------T-----?----X----M--------||-M---|----?--------------|-|--o---X---X--|----M--|--|M---X|-----|--?|-|-?-??T--X
XXXXXXXXXXXXXXXXXXXXXXXXXXXXXXXXXXXXXXXXXXXXXXXXXXXXXXXXXXXXXXXXXXXXXXXXXXXXXXXXXXXXXXXXXXXXXXXXXXXXXXXXXXXXXXXXXXXXXXXXXXXXXXXXXXXXXXXXXXXXXXXXXXXXXXXXXXXXXXXXXXXXXXXXXXXXXXXXXXXXXXXXXXXXXXXXXXXXXXXX
