--M-T-------T-------------------------------------------------------------T-------B----------o-----?---------------------------------------E----------T------?o-----------M-------------|---------------
--------------------------X---------M-----------------XE--------------------------------------X---------------------------------------------------------------------------------------------------------
---E------------------o---------B--------------------------------------------------------------------T--------B----------------------------------------?------------------------------------------------
-----------B--------------------------------?-------M-----------------------------------------T-----------------o--------M----------------?-------T----------------------------------------E------------
---------o-----------MB--|-----|----------B---------------------------------------------------------E------------|---T-------------M--------------------------------------------------------------------
-----------------------oT----------------------------------M------------E-----?------o----------------------------------E-B----------------------------------------B------------------------------------
-----------------o----------------o---------------------T------------------------------------------X------------------------------------o------E---------M------E--------------------------T-----E------
--------o--------T---?---B--o-----------------------M-------M------B-----------------------------T----------M----T-----------M------------oB---------------------------------oM------------------------v
-B------B---------------o---B---------T----------------------------------------E---------------T-----------------------B----XB----------------------------------X---------------------------E----------f
-----B-X--M-----------E------------------------------X-----------------------B-----------------------------------------------------------XTX-----------------------|--------------------------o--------f
--?-----------------------------------------------------------------o--------------------------T---M-----------X-X------X--------------------------------X------------------M|------?------------------f
----------------------------X-----------------------------o----------------------------------?-------------------------------------------------------------------------------------------------?-------f
----To--------|------------------------------------------------------------------------------E----------------?---------------------------------M--------------------M--------X--X---------------------f
--------E-------------------X----------------|---------------M-------------------------------------------o---------o---------------X-----E-----|--------------------BE--------------------------------?f
m------o--------------o----------------M---------------------|----------M--------------------------------------------------M----------|----------------------------------------------------------------X
XXXXXXXXXXXXXXXXXXXXXXXXXXXXXXXXXXXXXXXXXXXXTXXXXXXXXXXTXXXXXXXXXXXTXXXXXXXXXXXXXXXXXXXXXXXXXXXXXXXXXXXXXXXXXXXXXXXXXXXXXXXXXXXXXXXXXXXXXXXXXXXXXXTXXXXXXXXXXXXXXXXXXXXXXXXXXXX|XXXXXXXX?XBXXXXXXXXXXXXX
