BBX|-|---|--E-X-X-?---E---B-------------TE-M---EM-E---oEE-------------------M-----------------To---------E|-o---E---E-XoT---X---M-------o---------------o----BE-o-----|-|M|--E--X--XX---BB-----EE-------
--o---|-X--T---?B--MBo?-B?---------------|E--B-------------------------M---E?--T-T?B---Xo--X--B-------------M---------X--|---------Mo|-----------------------------------BB--------X--------------------
----------Xo?-X---M-|--M-X--M-M-----o--T------------------TT--------------X------|-------TB-||--B------------------------|-?-----?-|oB-----M?EXT----o---T----TB----M-M-o--ETo-M-------------------------
------?--|-----B-----------------------|-|--------------|---|T-|M----B-E----------------|-M----|--M-o--------------M-MX----?EE----ME--Mo---?E-o-|E?-oB--B-----B---||--XM-?-o-Mo----X-?T-o|-|?-o---o-----
-ET-oM----------------------?----------|E---------?-----?---?-M---M------|-?---|------------------T----o---------T-|----T---XM-----X--XT-----------------M----------------------------E-X---------o-M---
---B--------------|--------------------|----------------------------------?---X----BET--XM----MM?E---EoB---TT-M-X---?-----|X-B-BB--?-o-------o--|------------------------?--o--------------M-------B--T-
---BEE-X-T--------|--|XE-B---|----|---B||-?--------------M|-?-M--?-EE---------------|--------------------TT--------------------?E-?-T---T-M-----|-B--B-|--oo------------------------------------------|-
--------------TEXo-?--T?BT-|-|-------XM|E-------E-?|----ET-|B-X-E-oT-E?---?---------|--------BB----------------BB-----M--|---oB------ET-EM-------------------------|----|-X-X-B---T-------------------|v
-BX|--ME-o---|T-------------------o----|---o?E|------------|?XX-------?--X--?--o--X--X----|BT-T----E---|--MT----B----?--o||-M--T---?--E-------EX|o-XT-BXM-E-o?----ME-------------------T-B|-o-------TT|f
-B-?---EM------|--|E-M---|--o----------|---------|-|---?---|---------------------o--E--------X---------X-|---------------TT--BXM---EE-----------|-----------------|-------------|BM----?---o|-|------|-f
---E-M---T---M---E|----B--X-|-B--T|o-o-|?--TTE-----MB----o----?---T-E---X-----------|--B|BoT-----------------------------|----------------------|E-------X------|-||--T-oM---X----|-----E-o-?-T------||f
-T?-T?E|---B---------?-T--------T---E--|-|X-|?---BXE------X|-|-o-o--T--M|---oEM--E?-|---|--|?--|--M-E-----|-E|---oM------|-----E----BB----------|----------?-----||-----------------------|----B----M|-f
-----?----------M?M-EM----M-o?--|-----T|E--|--|----------?--|Mo||X---TT---M------E--|--M-B?-o---XE-------||-XE---------o--|---------------------|--------XB----?-------------------------------|-----|-f
--E---------------------T|o--MM--B?o|-||E|--|-?----X-M-----|-------B-|?-To-BTX-X----|Mo---M----|---------X---------------|------o-B-------------|---------|-------||-----------------B---------------||f
mE?E-B--o-MM------??Bo--|T--BX|?------||-?--|-----------------------?-------------Eo|-BT---?-X?-----------|---------------|---M--------------|--|-EBo|---BMX---?--o---X---Mo-----|X--??o-------M-----||X
XXXXXXXXXXXXXXXXXXXXXXXXXXXXXXXXXXXXXXXXXXXXXXXXXXXXXXXXXXXXXXXXXXXXXXXXXXXXXXXXXXXXXXXXXXXXXXXXXXXXXXXXXXXXXXXXXXXXXXXXXXXXXXXXXXXXXXXXXXXXXXXXXXXXXXXXXXXXXXXXXXXXXXXXXXXXXXXXXXXXXXXXXXXXXXXXXXXXXXXX
