-o--o----------------------------------X------o--------------------o-----------------o-----------------o--o----------o----------------o-----------------------------------------------------------------
--------------o-------o-----------------------------o--------o-------------------------oo---------------------o----------------o---o-----------------------------------------------------o-o----o-o-----
-----------------o--o-----------------------------------o------------o------------o-----o---o-------------------------o-----------o-----------o-oo---------------------o-o----------------------o-------
---------BB---BB--BBB-------------BB---------------------X----------BB----------------------------BB-BB------------------------------------BB----------BB---------B----------M--------------------------
----BB---------------------------------------------------------BB-------------------------------------------BB-------------BB------------------?BB----E--------?------X---------------------------------
BB------------------------BB----M----------------M--------------------T-----------------------------------------BB----------------?------------------BB-----------------------------T-------------------
------------------?-BB-----------------------BB----------X-----E------|--------------------------------BB---------------------------------------------------BB---------------B---B--|-BB----------------
---?--BB-------?-----------X------?----------------BB---B-----BB------|----------------------------------------------------------BB---------------------BB------BB------------------|------------------v
--------BB-----------------------------?--------?---------------------|----B----------BB-----------?---------X-------?o-BB--------M-----------------------------------BB------------|-----X------------f
-----------------------------------BB--------T---------BB---------BB--|-------BB----BB-----------BB----X--------------X------------------M-----------------?----------------------BB|----T-BB----------f
----?--------------------------BB----------?-|---BB-------------------|-----M----------------------?------------------------------?------------BB--T-?--------------------?---------|-B--|-------------f
-------------------------X-------------------|--------------M---------|--BB-----M---------------BB--------------------------------BB------BB-------|--------------------------------|----|-------------f
------------------------XXX-------------?----|---o------BB------------|-----------X--T-----------?BB---------o-------------------------------------|-BB-------XX--------------------|-BB-|-------------f
---------------------BB-XXXX-----------------|------------------X-X---|----------XXX-|----------------------XXXX------X--BB-X----------------------|---------XXXX-------------------|--M-|--?----------f
m---------------o---BB--XXXXX------------BB--|-T----------T----XXXXX-E|---------XXXXX|---BB----------------XXXXXX----XXX---XXX---------------------|--------XXXXXX---E-------o------|----|---------o---X
XXXXXXXXXXXXXXXXXXXXXXXXXXXXXXXXXXXXXXXXXXXXXXXXXXXXXXXXXXXXXXXXXXXXXXXXXXXXXXXXXXXXXXXXXXXXXXXXXXXXXXXXXXXXXXXXXXXXXXXXXXXXXXXXXXXXXXXXXXXXXXXXXXXXXXXXXXXXXXXXXXXXXXXXXXXXXXXXXXXXXXXXXXXXXXXXXXXXXXXX
