--------------------------------------------------------------------------------------------------------------------------------------------------------------------------------------------------------
--------------o-------------------------------o------------------------------------------------------------------------------------------------------------------------------------------------------o--
-----------------------------------------------------o--------------------------------------------------------o-----------------------------------------------------------o-----------------------------
----BB---------------------------E--------?---------BB--------B---------------?B----B------B-BBBB--------------------BBBB------------B----BB--BB-BB---?-?----BB-BBB-----BBB-------B-----BB-BB--B-B----B-
--B---------------o-----------?--BBB-------B-M-----------------------BBBB----------BBB--------------------------------o---------BBB-----------------------------------------BBBBBBB----BBB------BB-BB-B-
-------------BBB---BBBo----------------------------------B--------M-------M-------------B---------------EBBBB----------------------o-----------------------------------o----------------------E---------
---?---------------------X----------B-------------BB------------T-B--BB-----------------T------BBB------X------------oT-E-----------M-----T--?---BBBB-BBBBB--BB-T-------BBT----------o------------------
---B--------------------------------------------------------M---|-----------T----BB-----|-------------------B--------B|BB------BBB--BBBB--|---B-----B-----------|---------|----T---BBBBBB--------BBB---v
--------M------------B-BBB-------?----------T-----------------T-|o-------T--|-----------|----------BB-o--------o------|-------------------|---------------------|---------|----|-----------------?-----f
-----M--?------------------------------T?--B|------E----------|-|--------|--|-----------|----------B-TB--BB----B-B----|-----------E-M-----|--------M----BBBB--T-|----B----|B-B-|--B----------?---------f
-----T--------------------------?------|----|-----BB--------?-|-|--------|--|-----------|------------|------------E---|-B-BBB-----B---B-X-|-------E---T-------|-|-BBB-----|---B|----BBB----------------f
-----|------------M----T-?------TM-----|----|--------B----?---|B|------BB|--|------T----|-?------?---|--o-------------|-------------------|--B-------B|-------|-|------E--|----|-------?----------B--M-f
---B-|?----------------|B-------|------|B---|----------B------|-|--------|--|-XXX--|B-o-|B-----------|--BB-----BB-----|----o---E---------B|B----E-B---|-------|-|---------|---M|-------------M--B------f
-----|---------T--B----|--------|------|----|-----X-----o-----|-|-----oB-|--|XXXXX-|--o-|B-----------|----B-------BB--|---B------B----E---|?-E--------|---?---|-|-o----E--|--B-|-----E--------------E--f
m----|-E-------|-----o-|--------|-EX---|---?|--oBXXX---BoXX---|-|--T-----X-XXXXXXXX|--oo|-------BB--o|--o------E----E-|----o-------o------|---T-----XM|-------|-|------XXE|----|-B--oTT-E----XX----BBB-X
XXXXXXXXXXXXXXXXXXXXXXXXXXXXXXXXXXXXXXXXXXXXXXXXXXXXXXXXXXXXXXXXXXXXXXXXXXXXXXXXXXXXXXXXXXXXXXXXXXXXXXXXXXXXXXXXXXXXXXXXXXXXXXXXXXXXXXXXXXXXXXXXXXXXXXXXXXXXXXXXXXXXXXXXXXXXXXXXXXXXXXXXXXXXXXXXXXXXXXXX
