-----o----------------X--o--------B-E-BEM----E----?X?------------------X--XB--BMB------------------------E-XE-----------EB-----------------X---------BB------B-o----------------------------------------
-----------EE---M--?----------o---M---E-------------------------------o-EoB--?BE------M-oo-------------M---B---------------?--X-BB-B--M--------o--M-----o-E-X----B--o-----------------------------------
-----o---------M---M----M-------B------------X------------M----?--M----E---------------------------------------------E--?--B---------B--------X-----BB-X-o----E-----------------------------------------
-----------M----E---------------------B--?-?-----------------------------------------------------------------------o-o-------?-X-----M------------E----------XX--?--M-----?-------M----o--EE------------
---M-----------X-------------?--X--??X---o-----X------M-----------M---X--X-o--------------------------M----?---------X?--------------------B?--o------?------------X----------X--------X----------------
------X-------------------B--------------------------------------------------o-M---T-----?B-----E--B---------------oB-B-?------------------?-------------------------------------X-----------TM---------
----------------o-M----E----------------------------------------MM--?-----------oE?|----------X?---B--------B------o?-----X--------o-----------------?-------?M----?---XE----------------X---|----------
--B--------------X-----------------------------------------------------------------|------------o-----M-------------------E--E---------B---X-----------X---B--M-?X--------------------E------|---------v
--------E----------------B--B-----M---?E---E--o---MMM-------XX-----------X---------|--M-------------?M--------------------------------------X----M-------M-----X-Eo-oE--?---X---------M------|o----o---f
----X--------------B--MXM-----o----o--------------------------oE---E-E--E--X?X-----|------o-B------EE---B-M-------?----E---------------o----------X--B-------?--o--M---o------------E-----B-X|-B-------f
-----------------B-----M------o-BB--E---ME---BM-E-oE---M--MX-----M----------Mo-M--X|-----M--------------o---------E---------------M---B-----o--o------BM----------E------?-B---EM--------T---|---------f
----?--o----------o----------------------------------------------------------------|------M-------------------------?ME------------B---------------------------E------M------------------|---|---------f
--o----T----M--------------M--E-X-?------M------X-------E-??---E-X----BX-----------|-------------E----------------------B-----------o-M-X?----------------------------?--B-B-X---------Mo|---|--M------f
---?---|----o---------------?------------------E----X---Eo-?-X--?E--o-------o------|-------------------?-M----M--------EE-BTTo--?M--X--------M----X-----------B-E----------------X-------|---|---------f
mB-----|M----------------B----?----------X-B-------??--M-X------B------------------|---------------------M----X---E--M-----||--------------------B------M------------------------TM------|---|---------X
XXXXXXXXXXXXXXXXXXXXXXXXXXXXXXXXXXXXXXXXXXXXXXXXXXXXXXXXXXXXXXXXXXXXXXXXXXXXXXXXXXXXXXXXXXXXXXXXXXXXXXXXXXXXXXXXXXXXXXXXXXXXXXXXXXXXXXXXXXXXXXXXXXXXXXXXXXXXXXXXXXXXXXXXXXXXXXXXXXXXXXXXXXXXXXXXXXXXXXXX
